WWWWWWWWWWWWWWWWWWWWWWWWWWWWWWW
WPPPPPPPPPWPWPPPPPPPPPPPPPWPPPW
WWWWWWWWWPWPWPWWWWWWWPWWWWWPWPW
WDPPPPPPWPWPWDPPPPWPPPWDPPWPWPW
WPWPWWWWWPWPWWWPWWWPWPWPWPWPWPW
WPWPPPPPPPWDPPPPWPPPWDWPWPPPWPW
WPWWWWWWWWWPWWWWWPWWWWWPWWWWWPW
WPPPWDPPPPWPPPPPWPPPPPPPWPPPWPW
WWWPWPWWWPWWWWWPWWWWWWWWWPWWWPW
WPPPWPWPPPPPPPWPPPPPPPPPPDWPPPW
WPWWWPWWWWWWWWWWWWWPWWWWWPWPWWW
WPWPPPWDPPWDPPPPPPPPWPPPWPWPPDW
WPWPWWWPWPWPWWWWWWWWWPWPWPWWWPW
WPWPPPPPWPWPWPWPPPPPWPWPWPPPWPW
WPWWWPWWWPWPWPWPWWWPWPWPWWWWWPW
WDPPWPPPWPPPPPWPPPWPDPWPWPPPWPW
WWWPWPWWWWWWWWWWWPWWWWWPWPWPWPW
WPPPWPWPPPPPPPPPPPWPPPWPPPWPWPW
WPWWWWWPWWWWWPWWWWWWWPWWWWWPWPW
WPPPPPWDPPPPWPWDPPPPWPWPPPWPWPW
WWWWWPWPWWWPWWWPWWWPWPWPWPWPWPW
WPWDPPWPPPWPPPWPWPPPWPPPWPWPWPW
WPWPWWWWWWWWWPWPWPWWWWWWWPWPWPW
WPWPPPPPPPPPWPWPWPPPPPPPWPPDPPW
WPWWWWWWWWWPWPWPWWWWWWWPWWWWWPW
WDPPPPPPWDPPWDPPPPWDPPWDPPWPWPW
WPWPWWWPWPWWWPWWWWWPWPWPWPWPWPW
WPWPPPWPWPWGPPPPWPPPWPWPWPWDPPW
WPWWWPWWWPWWWWWWWPWWWPWWWPWPWWW
WPPPWDPPPPPPPPPPPPWPPPPPPPWPPPW
WWWWWWWWWWWWWWWWWWWWWWWWWWWWWWW